^^^^       ATTACK ~~~~
  ^^^------HHHHHHH--~~
           H  o  H  ~~
           HHAAAHH   ~
       HHHHHHH       |
OTHERS H o   O       =
^^^^^^ HHHHHHH HDDDH |
^^^^^^^^^^     H o H |
^^^^^^^^^^^^   HHHHH |
^^^^^^^^^^^^^DEFENCE-|